1 3 2 1 0
4 4 4 2 0
2 2 1 3 3
3 3 3 0 0
1 1 1 0 0